
ASMENINIS	A S M E N IH N IH S
ATPAŽINIMAS	A T P A ZH IH N IH M A S
BALSO	B A L S OO
DARBO	D A R B OO
DŪMĄ	D UW M AA
EFEKTYVI	E F E K T IY V IH
EIK	EI K
FILMĄ	F IH L M AA
Į	IY
IŠEITI	IH SH EI T IH
IŠ	IH SH
IŠTRINK	IH SH T R IH N K
JAVA	Y A V A
JONUI	Y OO N UI
KAIP	K AI P
KLAUSYTI	K L AU S IY T IH
KNYGĄ	K N IY G AA
LAIKRAŠTĮ	L AI K R A SH T IY
LAIŠKUS	L AI SH K UH S
MARTI	M A R T IH
MENIU	M E N IH UH
MINDAUGUI	M IH N D AU G UI
MUZIKĄ	M UH Z IH K AA
NAUJIENAS	N AU Y IE N A S
NUOTAKA	N UO T A K A
PADĖK	P A D EH K
PAGELBA	P A G EL B A
PAGRINDINĮ	P A G R IH N D IH N IY
PAGRINDINIS	P A G R IH N D IH N IH S
PARODYTI	P A R OO D IY T IH
PASKAMBINK	P A S K A M B IH N K
PAŽYMĖK	P A ZH IY M EH K
PERBĖGTI	P E R B EH G T IH
PERMESK	P E R M E S K
PERŽIŪRĖTI	P E R ZH IH UW R EH T IH
PRIEŠ	P R IE SH
PRIMINIMUI	P R IH M IH N IH M UI
PROGRAMOS	P R OO G R A M OO S
ŠACHMATAIS	SH A X M A T AI S
SEKANTI	S E K A N T IH
ŠIUKŠLINĘ	SH IH UH K SH L IH N EA
SKAITYK	S K AI T IY K
SKAITYTĄ	S K AI T IY T AA
SKAITYTI	S K AI T IY T IH
SKAMBINK	S K A M B IH N K
ŠNEKUČIAI	SH N E K UH CH IH AI
STATISTIKAS	S T A T IH S T IH K A S
STRAZDANOTA	S T R A Z D A N OO T A
TAI	T AI
TENISĄ	T E N IH S AA
VASARA	V A S A R A
VELNIO	V EL N IH OO
ŽAISTI	ZH AI S T IH
ŽINUTĘ	ZH IH N UH T EA
ŽINUTĖ	ZH IH N UH T EH
ŽIŪRĖTI	ZH IH UW R EH T IH
DELFĮ	D EL F IY
LIETUVOS	L IE T UH V OO S
RYTĄ	R IY T AA
ELERTĖ	EL E R T EH
RODYK	R OO D IY K
PANORAMĄ	P A N OO R A M AA
KAUNO	K AU N OO
ŽINIAS	ZH IH N IH A S